Species	Status
?Sallamys	extinct
Abalosia	extinct
Abrawayaomys	extant
Abrocoma	extant
Abrothrix	extant
Acarechimys	extinct
Acaremys	extinct
Aconaemys	extant
Actenomys	extinct
Adelphomys	extinct
Aegialomys	extant
Aenigmys	extinct
Aepeomys	extant
aff._Tarapotomys	extinct
Akodon	extant
Akodon_(Akodon)	extant
Allocavia	extinct
Alloiomys	extinct
Ameghinomys	extinct
Amphinectomys	extant
Anatochoerus	extinct
Andalgalomys	extant
Andemys	extinct
Andinomys	extant
Anotomys	extant
Arazamys	extinct
Artigasia	extinct
Asteromys	extinct
Auliscomys	extinct
Australoprocta	extinct
Balsayacuy	extinct
Banderomys	extinct
Bibimys	extant
Blarinomys	extant
Branisamyopsis	extinct
Branisamys	extinct
Briaromys	extinct
Brucepattersonius	extant
Cachiyacuy	extinct
Callistomys	extant
Calomys	extant
Canaanimys	extinct
Cantracavia	extinct
Cardiatherium	extinct
Cardiomys	extinct
Carlesia	extinct
Carterodon	extant
Cavia	extant
Caviocricetus	extinct
Caviodon	extinct
Cephalomyopsis	extinct
Cephalomys	extinct
Cercomys	extinct
Cerradomys	extant
cf._Cachiyacuy	extinct
cf._Eoespina	extinct
cf._Pozomys	extinct
cf._Tarapotomys	extinct
Chachapoyamys	extinct
Chaetomys	extant
Chambiramys	extinct
Changquin	extinct
Chasichimys	extinct
Chasicomys	extinct
Chelemys	extant
Chibchanomys	extant
Chilomys	extant
Chinchilla	extant
Chinchillula	extant
Cholamys	extinct
Cholomys	extinct
Chubutomys	extinct
Chukimys	extinct
Clyomys	extant
Coendou	extant
Colomys	extant
Colpostemma	extinct
Contracavia	extinct
Ctenomys	extant
Cuniculus	extant
Dactylomys	extant
Dankomys	extinct
Dasyprocta	extant
Delomys	extant
Deltamys	extant
Deseadomys	extinct
Diaphoromys	extinct
Dicardia	extinct
Dicolpomys	extinct
Dinomys	extant
Diplomys	extant
Discolomys	extinct
Disteiromys	extinct
Doellomys	extinct
Dolicavia	extinct
Dolichotis	extant
Doryperimys	extinct
Draconomys	extinct
Drymoreomys	extant
Drytomomys	extinct
Dudumus	extinct
Echimys	extant
Eligmodontia	extant
Eobranisamys	extinct
Eocardia	extinct
Eocardia_(Dicardia)	extinct
Eodelphomys	extinct
Eodolichotis	extinct
Eoespina	extinct
Eoincamys	extinct
Eopicure	extinct
Eopululo	extinct
Eosachacui	extinct
Eosallamys	extinct
Eosteiromys	extinct
Eoviscaccia	extinct
Eremoryzomys	extant
Erethizon	extinct
Ethelomys	extinct
Eucelophorus	extinct
Eucoelophorus	extinct
Eumegamys	extinct
Eumegamysops	extinct
Eumysops	extinct
Euneomys	extant
Euryoryzomys	extant
Euryzygomatomys	extant
Eusigmomys	extinct
Ferigolomys	extinct
Galea	extant
Galenomys	extant
Galileomys	extinct
Garridomys	extinct
Geoxus	extant
Graomys	extant
Guiomys	extinct
Gyldenstolpia	extant
Gyriabrus	extinct
Handleyomys	extant
Haplostropha	extinct
Heteromys	extant
Holochilus	extant
Hoplomys	extant
Hydrochoeropsis	extinct
Hydrochoerus	extant
Hylaeamys	extant
Hypsosteiromys	extinct
Ichthyomys	extant
Incamys	extinct
Irenomys	extant
Isostylomys	extinct
Isothrix	extant
Josephoartigasia	extinct
Juliomys	extant
Juscelinomys	extant
Kannabateomys	extant
Kerodon	extant
Kichkasteiromys	extinct
Kraglievichimys	extinct
Kunsia	extant
Lagidium	extant
Lagostomus	extant
Lagostomus_(Lagostomopsis)	extinct
Lapazomys	extinct
Lenoxus	extant
Leucokephalos	extinct
Litodontomys	extinct
Llitun	extinct
Lonchothrix	extant
Loncolicu	extinct
Loretomys	extinct
Loxodontomys	extant
Luantus	extinct
Lundomys	extant
Makalata	extant
Marisela	extinct
Maruchito	extinct
Massoiamys	extinct
Matiamys	extinct
Mayomys	extinct
Megactenomys	extinct
Megaoryzomys	extant
Megastus	extinct
Melanomys	extant
Mesomys	extant
Mesoprocta	extinct
Microakodontomys	extant
Microcardiodon	extinct
Microcavia	extant
Microryzomys	extant
Microsciurus	extant
Microscleromys	extinct
Microsteiromys	extinct
Migraveramus	extinct
Mindomys	extant
Miochinchilla	extinct
Myocastor	extant
Myoprocta	extant
Neacomys	extant
Necromys	extant
Nectomys	extant
Neocavia	extinct
Neochoerus	extinct
Neoepiblema	extinct
Neophanomys	extinct
Neoreomys	extinct
Neosteiromys	extinct
Neotomys	extant
Nephelomys	extant
Nesoryzomys	extant
Neusticomys	extant
Niedemys	extinct
Noronhomys	extinct
Nothydrochoerus	extinct
Notiomys	extant
Nuyuyomys	extinct
Octodon	extant
Octodontomys	extant
Octomys	extant
Oecomys	extant
Olallamys	extant
Olenopsis	extinct
Oligoryzomys	extant
Olympicomys	extinct
Oreoryzomys	extant
Orthogeomys	extant
Orthomyctera	extinct
Oryzomys	extant
Oxymycterus	extant
Palaeocavia	extinct
Palaeoctodon	extinct
Palaeosteiromys	extinct
Pampamys	extinct
Panchomys	extinct
Paradelphomys	extinct
Paradoxomys	extinct
Paralomys	extant
Paramyocastor	extinct
Paranamys	extinct
Parasteiromys	extinct
Pardinamys	extinct
Parodimys	extinct
Pascualia	extinct
Pattonomys	extant
Paulacoutomys	extinct
Pearsonomys	extant
Pediolagus	extinct
Pentastylodon	extinct
Pentastylomys	extinct
Perimys	extinct
Phaenomys	extant
Phanomys	extinct
Phoberomys	extinct
Phtoramys	extinct
Phugatherium	extinct
Phyllomys	extant
Phyllotis	extant
Pipanacoctomys	extant
Pithanotomys	extinct
Platypittamys	extinct
Plesiacarechimys	extinct
Plesiosteiromys	extinct
Pliodolichotis	extinct
Pliolagostomus	extinct
Podoxymys	extant
Potamarchus	extinct
Pozomys	extinct
Praectenomys	extinct
Proatherura	extinct
Procardiomys	extinct
Proclinodontomys	extinct
Prodolichotis	extinct
Proechimys	extant
Prolagostomus	extinct
Propediolagus	extinct
Prospaniomys	extinct
Prostichomys	extinct
Protabrocoma	extinct
Protacaremys	extinct
Protadelphomys	extinct
Protomegamys	extinct
Protosteiromys	extinct
Pseudoacaremys	extinct
Pseudoplataeomys	extinct
Pseudopotamarchus	extinct
Pseudoryzomys	extant
Pseudosigmomys	extinct
Punomys	extant
Quebradahondomys	extinct
Reigechimys	extinct
Reithrodon	extant
Reithrodontomys	extant
Rhagomys	extant
Rhipidomys	extant
Rhodanodolichotis	extinct
Ricardomys	extinct
Rusconia	extinct
Salinomys	extant
Sallamys	extinct
Santamartamys	extant
Saremmys	extinct
Scapteromys	extant
Schistomys	extinct
Sciamys	extinct
Sciurillus	extant
Sciurus	extant
Scleromys	extinct
Scolomys	extant
Scotamys	extinct
Selvamys	extinct
Shapajamys	extinct
Sigmodon	extant
Sigmodontomys	extant
Simplimus	extinct
Sooretamys	extant
Soriamys	extinct
Spalacopus	extant
Spaniomys	extinct
Steiromys	extinct
Stichomys	extinct
Strophostephanos	extinct
Tacheria	extinct
Tafimys	extinct
Tapecomys	extant
Tarapotomys	extinct
Telicomys	extinct
Telodontomys	extinct
Tetrastylomys	extinct
Tetrastylus	extinct
Thalpomys	extant
Thaptomys	extant
Theridomysops	extinct
Thomasomys	extant
Thrichomys	extant
Toromys	extant
Transandinomys	extant
Trinomys	extant
Tylomys	extant
Tympanoctomys	extant
Ucayalimys	extinct
Ullumys	extinct
Vallehermosomys	extinct
Vucetichimys	extinct
Wiedomys	extant
Wilfredomys	extant
Willidewu	extinct
Xenocardia	extinct
Xenodontomys	extinct
Xylechimys	extinct
Zygodontomys	extant
