Species	Status
Caluromys	extant
Caluromysiops	extant
Chacodelphys	extant
Chironectes	extant
Cryptonanus	extant
Didelphis	extant
Glironia	extant
Gracilinanus	extant
Hesperocynus	extinct
Hyladelphys	extant
Hyperdidelphys	extinct
Lestodelphys	extant
Lutreolina	extant
Marmosa	extant
Marmosops	extant
Metachirus	extant
Monodelphis	extant
Philander	extant
Sairadelphys	extinct
Sparassocynus	extinct
Thylamys	extant
Thylatheridium	extinct
Thylophorops	extinct
Tiulordia	extinct
Zygolestes	extinct
